3 3 3 0 1 0 1 0 1 0 3 3 3
3 4 3 1 0 1 0 1 0 1 3 4 3
3 3 3 0 1 0 1 0 1 0 3 3 3
1 0 1 3 4 4 4 4 4 3 1 0 1
0 1 0 5 1 0 1 0 1 5 0 1 0
1 0 1 4 0 1 0 1 0 4 1 0 1
0 1 0 4 1 0 1 0 1 4 0 1 0
1 0 1 4 1 0 6 1 0 4 1 0 1
0 1 0 4 0 1 0 1 0 4 0 1 0
1 0 1 4 1 0 1 0 1 4 1 0 1
0 1 0 5 0 1 0 1 0 5 0 1 0
0 1 0 3 4 4 4 4 4 3 0 1 0
3 3 3 0 1 0 1 0 1 0 3 3 3
3 4 3 1 0 1 0 1 0 1 3 4 3
3 3 3 0 1 0 1 0 1 0 3 3 3