3 3 3 0 1 0 1 0 1 0 3 3 3
3 2 3 1 0 1 0 1 0 1 3 2 3
3 3 3 0 1 0 1 0 1 0 3 3 3
1 0 1 3 2 2 2 2 2 3 1 0 1
0 1 0 5 1 0 1 0 1 5 0 1 0
1 0 1 2 0 1 0 1 0 2 1 0 1
0 1 0 2 1 0 1 0 1 2 0 1 0
1 0 1 2 1 0 0 1 0 2 1 0 1
0 1 0 2 0 1 0 1 0 2 0 1 0
1 0 1 2 1 0 1 0 1 2 1 0 1
0 1 0 5 0 1 0 1 0 5 0 1 0
0 1 0 3 2 2 2 2 2 3 0 1 0
3 3 3 0 1 0 1 0 1 0 3 3 3
3 2 3 1 0 1 0 1 0 1 3 2 3
3 3 3 0 1 0 1 0 1 0 3 3 3