2 2 2 0 1 0 1 0 1 0 1 0 2 2 2
2 3 2 1 0 1 0 1 0 1 0 1 2 3 2
2 2 2 0 1 0 1 0 1 0 1 0 2 2 2
0 1 0 2 4 5 5 5 5 5 4 2 0 1 0
1 0 1 5 1 0 1 0 1 0 1 5 1 0 1
0 1 0 5 0 1 0 1 0 1 0 5 0 1 0
1 0 1 5 1 0 1 6 1 0 1 5 1 0 1
0 1 0 5 0 1 0 1 0 1 0 5 0 1 0
1 0 1 5 1 0 1 0 1 0 1 5 1 0 1
0 1 0 2 4 5 5 5 5 5 4 2 0 1 0
2 2 2 0 1 0 1 0 1 0 1 0 2 2 2
2 3 2 1 0 1 0 1 0 1 0 1 2 3 2
2 2 2 0 1 0 1 0 1 0 1 0 2 2 2